a fire hose = un tuyau d'incendie
it is daunting = c'est intimidant, décourageant
a discrepancy = une contradiction, un désaccord
apropos = (preposition) with reference to, concerning
a wallop, to wallop = a heavy blow or punch//strike or hit (someone or something) very hard
it is transient = c'est transitoire, éphémère, lasting only for a short time
a bias = prejudice in favor of or against one thing, person, or group compared with another, usually in a way considered to be unfair; un préjugé, un penchant
bursty (traffic) = (traffic) occurring at intervals in short sudden episodes or groups
an incipient thing = une chose naissante, qui commence
to silence it = faire taire quelque chose
to get spooker = scared, bewildered (déconcerté), nervous
to be bewildered = cause (someone) to become perplexed and confused
to be poised = having a composed and self-assured manner, être prêt
to have remorse = avoir des remords
to stitch it up = recoudre ça
the thigh = la cuisse
stamina = the ability to sustain prolonged physical or mental effort, endurance, vigueur, résistance
it is compound, it is a compound = c'est composé, c'est un composé
to outrun someone = dépasser, surpasser, distancer (ex: they outrun their competitors)
scaffolding/scaffolds = un échafaudage
first and foremost = tout d'abord, avant tout (ex: I am first and foremost a writer)
to draw a parallel between something and something = faire un parallèle, une comparaison
a milepost = a post (poteau) indicating the distance in miles from or to a given point//a post placed a mile from a similar post
step to the fore = make oneself visible or take action (ex: "Young people should step to the fore and help their peers")
to take a step = to do what is necessary to prevent something (ex: They took steps to keep their plans secret)
a cornerstone = une pierre angulaire
a saw = une scie
sawtooth (adj) = en dents de scie
adversely = défavorablement
to halve something = réduire de moitié
the backlog = an accumulation of something, especially uncompleted work or matters that need to be dealt with
public at large = general public
readily = facilement//without hesitation or reluctance; willingly
in place of = instead of
whereby = by which (ex: a system whereby people could vote by telephone)
wit = noun: mental sharpness and inventiveness; keen intelligence//verb: that is or say OR have knowledge
verbe = avec brio (with verve), vigor and spirit or enthusiasm
swagger = a very confident and typically arrogant or aggressive gait or manner (noun)//verb: fanfaronner, se pavaner
a till = une caisse (de supermarché)
swab = noun: an absorbent pad or piece of material used in surgery and medicine for cleaning wounds, applying medication, or taking specimens//verb: clean (a wound or surface) with a swab
chap = un type, un mec
sparsely = peu
spurious = not being what it purports to be,false or fake, faux
to purport = prétendre, claim to be (ex: she is not the person she purports to be)
the purport = la portée, la teneur, la signification (ex: I do not understand the purport of your remarks)
marble = marbre, bille (en verre)
to be assertive = having or showing a confident and forceful personality, être assuré
tedious = fastidieux, ennuyeux, lassant, too long, slow, or dull
tiresome = causing one to feel bored or annoyed
bully = noun or verb: un tyran, une brute (brutaliser), malmener
with contempt = avec mépris
to be subpoenaed = être cité à comparaître
a comrade = un camarade
to disavow = désavouer, dénier (ex: he appears to be in denial of his own past, which he continually disavows)
a foe = an enemy or opponent
it's rotten = c'est pourri
decay = verb or noun: se désintégrer, pourrir, la pourriture
to sever = divide by cutting or slicing, especially suddenly and forcibly, rompre, couper, trancher
a tidal wave = un raz-de-marée
sorry for the wait = désolé pour l'attente
the next drink is on me = le prochain verre est pour moi
a lorry, a truck = un camion
to grind = moudre, broyer
it's legible, readable = c'est lisible
a vessel = a ship, a large boat
a binder = un classeur
sketchy = vague, incomplet, not thorough or detailed
a tailpipe = un pot d'échappement
a pier = une jetée//un pilier
to meet expectations = atteindre des objectifs ou attentes
an endeavour, to endeavour = un effort, une tentative, an attempt to achieve a goal//tenter, essayer de faire, try hard to do or achieve something
outright = carrément, franchement, complétement//absolu, pur, total, complet
to boast = fanfaronner, talk with excessive pride and self-satisfaction about one's achievements, possessions, or abilities
retaliation = représailles, vengeance, the action of returning a military attack, counterattack
with hindsight = avec sagesse retrospective, en y repensant (ex: with hindsight , I should never have gone)
a crane = une grue de chantier
utterly = totalement, complètement
a spire = a tapering conical or pyramidal structure on the top of a building, typically a church tower
to step up = to increase, especially in stages//to come forward//to improve one's performance or take on more responsibility, especially at a crucial time (ex: I want you to step up)
a steeple = un clocher
to be sultry = (of the air or weather) hot and humid//(especially of a woman or her behaviour) displaying or suggesting a strongly sexual nature
a cheetah = un guépard
to taper = aller en diminuant, finir en pointe
a taper = un cierge
it's slender = mince, svelte, (of a person or part of the body) gracefully thin//(of something abstract) barely sufficient in amount or basis
commonplace = not unusual, ordinary, banal
(with) tongue in cheek = speaking or writing in an ironic or insincere way
tapestry = tapisserie
pro-bono = for the public good, pour le bien public
a slut, a whore, a prostitute, a hooker = une salope, une pute
a dipper = une louche
to swipe = to steal//pass (a swipe card) through an electronic device//to hit (ex: she swiped me right across the nose)
a quarry = une carrière (de pierre), une proie
to endeavor = to strive to achieve or reach, to attempt
to take a test = passer un test ou examen
to cope with something = (of a person) deal effectively with something difficult (ex: his ability to cope with stress), faire face à quelque chose
to falter = vaciller, faiblir, start to lose strength or momentum
staggering(ly) = causing great astonishment, amazement, or dismay//overwhelming
the dismay = la consternation
it's subsidized = c'est subventionné
overwhelming = accablant, écrasant, very great in amount
to snag = to tear, break, hinder, or destroy by or as if by a snag//to catch or obtain quickly or unexpectedly
a snag = un accroc
to hinder = create difficulties for (someone or something), resulting in delay or obstruction
the hind leg = jambe de derrière
a calf = un veau, un mollet
a crate = une caisse, un cageot, une cagette, une boite
dull = terne, ennuyeux, stupid
the grief = deep sorrow, especially that caused by someone's death
to grieve = suffer grief
to mourn = pleurer la mort de quelqu'un, faire le deuil
a grave = une tombe
a cemetery, graveyard = un cimetière
the infirmary = l'infirmerie
to fidget = to make small movements, especially of the hands and feet, through nervousness or impatience
to praise someone for something = to acclaim, expression of approval, commendation or admiration
dismally = lamentablement
perspiration = transpiration, the process of sweating
a yearning = une aspiration, une nostalgie, désir ardent
to be longing to something = a strong persistent yearning or desire, especially one that cannot be fulfilled
to be cross = to be annoyed
it's wearisome = c'est ennuyeux
to pine after someone or something = to long for or grieve for someone or something, se languir
to fret = to be vexed or troubled, worry, se tracasser (ex: she fretted about something)
to fade = to lose brightness, loudness, or brilliance gradually
to dwindle = to become gradually less until little remains, to decrease (ex: difficulties that dwindled my enthusiasm for the recipe)
a plea = an earnest entreaty or request//an excuse, a pretext
to give in to something = to cease fighting or aguing, to admit defeat
to dip in (to something) = to reach into a liquid
to do a push-up = faire une pompe
to put someone up = to ​provide someone with a ​place to ​stay ​temporarily
appealing = having appeal, attractive
appaling = horrifying and astonishing
a rut = a long deep track made by the repeated passage of the wheels of vehicles//in a rut: dans une routine
to lag behind someone or something = to linger behind someone or something, to fall behind someone or something
to work your fingers to the bone = to work very hard
until you are blue in the face = if you say something until you are blue in the face, you keep saying the same thing again and again but no one listens to you
to give up the ghost = to die
to queue up, to line up = form a queue, form a line, stand in line, ex: Customers lined up in front of the store
to speak jabberwocky = total nonsense, a fit of rambling which resembles a civilized language but in fact is meant only to obfuscate meaning or confuse the victim, or listener
a rambling thing = (of writing or speech) lengthy and confused or inconsequential//(of a plant) putting out long shoots and growing over walls or other plants, climbing
a pipe dream = an unattainable or fanciful hope or scheme
to blow someone or something away = to carry someone or something away//to blow someone away: to cause someone great pleasure or surprise
to give on someting = to pretend something in order to deceive another (ex: The con artist gave on that he was a car salesman, although in fact he knew very little about cars)
a con artist = a person who cheats or tricks others by persuading them to believe something that is not true, un spécialiste de l'escroquerie
to let something slip = to reveal something inadvertently in the course of a conversation
hence = par conséquent, d'où//in the future
to inscribe = to write or carve words or symbols on something
to initial a document = parapher un document
to adjourn something = ajourner, reporter
to recess something = to attach (a fixture) by setting it back into the wall or surface to which it is fixed//(of formal proceedings) be temporarily suspended
a recess = un renfoncement dans un mur//a period of time when the proceedings of a parliament, committee, court of law, or other official body are temporarily suspended//récréation à l'école
to have bigger/other fish to fry = avoir d'autres chats à fouetter
to boot = in addition, also, besides
to be off the hook = no longer in difficulty or trouble
to be severed = être sectionné, coupé
to discard something = to get rid of something
notwithstanding = in spite of (preposition)//nevertheless (adverb)//although, in spite of the fact that (conjunction)
to drown = se noyer
to pull rank on someone = to use the power of your job or position to make someone do what you want
to tread the boards = faire du théâtre
to tread (trod, trod) = marcher, fouler
to refurbish something = to renovate and redecorate
a shipshape thing = orderly and neat, tidy
(a) pie in the sky = something good that is unlikely to happen//a future reward after death, considered as a replacement for a reward not received on earth//having to do with a hope for a special reward
a cock-and-bull story = une histoire à dormir debout
a smoke screen = un écran de fumée
an oath = un serment (ex: an oath of allegiance to someone)//un juron
to be stranded = être échoué
the heel = le talon
to ditch something = to get rid of, to give up, laisser tomber
a coat hanger = un cintre
draft beer (US), draught beer (UK) = bière pression
to be stubborn = être têtu
a dove = une colombe
a lamp shade = un abat-jour
allowances = allocations, indemnités//permitted amount or quantity
to shatter = exploser, fracasser
a bunk bed(s) = lit(s) surperposé(s)
a zipper = une braguette, fermeture éclair
zit, pimple (a red spot) = bouton d'acné (bouton classique)
blemishes = traces de boutons laissées sur le visage
whithead, blackhead = bouton blanc, point noir
to be game for something, to be up for something = to be willing to do something//être partant pour quelque chose
to win by X = gagner un match de X points, ou buts
a fitting room = une cabine d'essaye de magasin
to foster something, someone = to ​encourage the ​development or ​growth of ​ideas or ​feelings//to take ​care of a ​child, usually for a ​limited ​time, without being the child's ​legal ​parent
a goalkeeper = un gardien de but
the carpet is threadbare = le tapis est usé
to hold on to something, a relationship = to keep//rester dans une relation
to cram something into something = caser, fourrer quelque chose dans quelque chose
it's a shot in the dark, it's like shooting in the dark = a very general attempt, a wild guess, une prévision totalement aléatoire
a vaccine = un vaccin
an accident = un accident involontaire
a car collision = un accident de voiture avec quelqu'un reponsable
an intersection, a crossroad = une intersection
a disinfectant = un désinfectant
a bandage = un pansement
to fancy someone, to have a crush on someone = fancy: to like or admire someone//both: to be physically or emotionally attracted to someone
she was eager to get started = strongly wanting to get started
my legs are feeble = mes jambes sont faibles
please get me off = stp fais-moi venir
to cum = éjaculer//avoir un orgasme
a jaunt = une balade//a short excursion or journey for pleasure
a (portable) (book/comb) binding machine = une relieuse (comb -> peigne)
a comb = un peigne
a bloke = a man, a guy
a cub = the young of a fox, bear, lion, or other carnivorous mammal
to humb someone = to have sexual intercourse with someone
thanks for reaching out = merci de m'avoir contacté
a shrimp = une crevette
a wrench, a spanner = une clé / une clé à molette
I made a reservation under/in the name of John = j'ai fait une réservation au nom de John
a flock of gulls = un troupeau de mouettes (flock can only be used with birds)
a glimpse = a momentary or partial view, aperçu
conjugation = conjugaison
to put up with something/someone = to endure, to tolerate
to paddle = pagayer
to brace = se consolider, se caler, se fixer
a contest = un concours
winter/Christmas break, Christmas holidays = vacances de Noël
homogeneous = homogène
at stake = at risk, at issue or in question, en jeu
to worship = vénérer (un dieu)
a steering wheel = un volant de voiture
to be on the fence about something = undecided about something
ubiquitous = omniprésent
to pick out something = to choose or select, to discern from the surroundings (distinguish)
pickle = cornichon
prominent = important and well-known, easily noticed or seen
to disregard something = to pay no attention to; leave out of consideration; ignore, to treat without due regard, respect, or attentiveness; slight
to soar = fly or rise high in the air (ex: the birds soared into the air), monter en flêche
it's worthwhile = worth the time, money, or effort spent; of value or importance / utile / qui en vaut le coup
to dread = to fear something that will or might happen
to empathise = understand and share the feelings of another
to sympathise = feel or express sympathy / avoir de la compassion
predicament = a difficult, unpleasant, or embarrassing situation / situation difficile, pétrin
sleet = neige fondue
the liver = le foie
a leech = une sangsue
to bullshit someone = raconter des conneries (péjoratif), mentir
in the usual sense (of the word) = dans le sens où on l'entend
bold = brave, courageous
the pond = l'étang
benevolent = bienveillant, kindly
(it's) about time = il était temps
to be discontinued = être arrêté, stoppé (the project has been discontinued)
idle = not working or active, unemployed, doing nothing
a crook = un escroc
a felon = un criminel
the pinnacle = le sommet, l'apogée
henceforth = from this time on or from that time on, désormais, à l'avenir
upside down = à l'envers, renversé
to value something = attacher de l'importance à quelque chose, apprécier quelque chose
a claw = une griffe d'animal
to unleash = libérer, débrider
outstanding = exceptionnel, remarquable
a visor = une visière, un pare-soleil
it's window dressing = something that is intended to make a person or thing seem better or more attractive but that does not have any real importance or effect, the act of decorating and arranging products to display in a store window
to zero out = to reduce to zero, to eliminate (a budget or budget item) by cutting off funding
(to) latch = un loquet (verrouiller un loquet)
the fairing = le carénage
to tip = basculer (et tomber), donner un pourboire
to topple over = se renverser, basculer, tomber
to be tipped (verb: tip) with something = to be covered at the extremity (mountains tipped with snow)
bottoms up = cul sec
to relight = to ignite or cause to ignite again (past participle: relit)
liftoff = décollage
transonic = vitesse du son
a leap / to leap = un saut, un bond / sauter, bondir
grid fins = ailettes grillagée à l'arrière des fusées ou bombes
coast = côte (océanique), (adj) descente en roue libre. ex: coast phase
nailed it = said when you completed a task successfully or got something right
to be flattered = être flatté
to cling = hold on tightly to, s'accrocher (physiquement ou sentimentalement)
untainted = intacte
filthy = crasseux, dégeulasse
to taint = entacher
to get the hang of something = to understand the technique of doing something, to perceive the meaning or significance of something
an aisle = un rayon de magasin
peeps = people (often used to refer to a person's friends or associates)
to rehearse = to practice, répéter, s'entraîner
smoothly = doucement
lectern, reading desk = pupitre, typiquement utilisé par le président pour parler
stagehand = machiniste
whereby = by which (ex: a system whereby people could vote by telephone)
a prop = un soutien (un pilier, tuteur, support)
a crutch = une béquille (pour marcher)
the armpit = l'aisselle
to bear in mind = to keep in mind
a saying = un dicton
a boner = une érection
a vacation hub = un centre de vacances
the cumbersomeness = la lourdeur (d'une expression ou d'une chose physique)
to tell off someone for something = to criticize someone angrily for doing something wrong
twinkle = scintillement dans l'oeil
dealership = concession automobile
to catch wind of something = avoir vent de quelque chose
to sit/to rest on one's laurels = se reposer sur ses lauriers
to taunt someone about something = provoke or challenge (someone) with insulting remarks
a riot = une émeute
loyalty card = carte de fidélité
your change = votre monnair (après avoir payé, la différence)
evergreen = conifère
to let someone go, to fire someone = virer quelqu'un
to assess the results = évaluer/estimer/juger les résultats
as a matter of act, in reality = en fait, en réalité
off-topic = hors sujet
disclaimer = a statement that is meant to prevent an incorrect understanding of something (such as a book, a movie, or an advertisement)
it's prevalant = c'est répandu, fréquent
I know, right? = je sais, merci
to linger = s'attarder, traîner
get on someone's nerves = to irritate or exasperate
to spar = se bagarrer
to spare = épargner (quelqu'un ou quelque chose), économiser
to wield = exercer (son pouvoir), manier (un couteau par exemple), brandir quelque chose
pants, trousers, slacks = pantalon
upholstery = tapisserie (de canapé ou fauteuil)
spread the word = faites passer le mot
armchair = fauteuil
a checkout, a cash desk = une caisse de magasin
thereby = by that means, as a result of that
to wiggle = remuer, se tortiller, se déhancher
propellant = combustible
I'm going to practice = je vais à l'entraînement
time is money = le temps c'est de l'argent
time flies, time passes very quickly = le temps passe vite
a spell = un sort, un charme, un sortilège, une courte période
a payroll = a list of a company's employees and the amount of money they are to be paid
to be flailing = wave or swing or cause to wave or swing wildly
to swing = se balancer
to nuke = attack or destroy with nuclear weapons
to swoon = s'évanouir, faint from extreme emotion
a die, a dice / dice = un dé, des dés
dubious = douteux, incertain, suspect
to carve something = tailler quelque chose
to (give a) call, to give a ring = téléphoner à quelqu'un
to forecast = to say that (something) will happen in the future : to predict (something, such as weather) after looking at the information that is available, prévoir
to foresee = to see or become aware of (something that has not yet happened), prévoir, prédire
to forsake something = abandonner quelque chose
to tackle = make determined efforts to deal with (a problem or difficult task), aborder
to mix them up = confondre deux personnes
to pull over a car = arrêter une voiture sur le côté
to be compelled to do something = having to do something, because you are ​forced to or ​feel it is ​necessary
disposable razor = rasoir jetable
a frisky pup = un chiot fringuant (playful and full of energy)
conspiracy theory = théorie du complot
molten = fondu
to get acquinted with something/someone = hardly know somone/get familiar with something
a regular pace = un rythme régulier
melted = fondu
beam = faisceau, poutre, poutrelle
sail = voile
over and over, again and again, repeatedly = encore et encore
hearth = foyer de cheminée
lobby = hall
hallway, corridor = couloir
a wry thing = using or expressing dry, especially mocking, humor / (of a person's face or features) twisted into an expression of disgust, disappointment, or annoyance
kink = entortillement, anomalie, noeud
squib = pétard
(to) cuddle = caresse(r), étreinte, (cajoler)
dust = poussière
wacky = funny or amusing in a slightly odd or peculiar way, farfelu
janitor = concierge
to replenish = fill something up again, remplir
to bark = aboyer
hideout = cachette
at first glance/sight = à première vue
at a glance = almost immediately
peasants = paysans
a puddle = une flaque
passers, passers-by = passants
to learn by rote (US)/heart (US & UK) = apprendre par coeur
to clink glasses = trinquer
fuse = fusible
the bulk = la masse, le volume
tight-knit = soudé, (of a group of people) united or bound together by strong relationships and common interests
eager = désireux, avide
windshield wiper = essuie-glace
to knit = tricoter, unir
the attrition = l'usure
trustful = de confiance
reliant = dépendant, confiant
self-reliant = autonome
to allege = prétendre / alléguer / claim or assert that someone has done something illegal or wrong, typically without proof that this is the case
lawn mower = tondeuse à gazon
to tinker = bricoler, attempt to repair or improve something in a casual or desultory way, often to no useful effect
casually = in an unconcerned manner, not methodically or according to plan
salvageable = récupérable
to climb/get/jump/leap on the bandwagon = prendre le train en marche
swell = la houle ((sea) swell(s)), a full or gently rounded shape or form
scrap = a small piece or amount of something, especially one that is left over after the greater part has been used, discarded metal for reprocessing (feraille)
forensics = criminalistrique, étude appronfie d'un crime
desultory = décousu / lacking a plan, purpose, or enthusiasm
lanky = dégingandé, someone ungracefully thin and tall
warehouse = entrepôt, magasin
to cater = s'occuper de la nourriture, fournir les repas
to relish = savourer, enjoy greatly
the ins and outs of something = les tenants et les aboutissants de quelque chose
to hail a cab / (to) hail = interpeller un taxi / la grêle, pleuvoir de la grêle
hammock = hamac
to snoop = espionner, fouiner, fureter
truth or dare = action ou vérité
even so = in spite of that, nevertheless
(to) stain = tâche(r)
to lead someone on/to be lead on = être mené en bateau, faire croire à quelqu'un qu'il peut y avoir quelque chose de sentimental alors que non
to baffle, to bewilder = déconcerter (quelqu'un)
for the time being, temporarily = temporairement, pour le moment
wrestling = lutte, catch
an upbringing = une éducation (parentale)
siblings = la fratrie
seafood = fruits de mer
neighboring car = voiture à côté de nous
smog = fog or haze with smoke and other atmospheric pollutants
recently, lately = not long ago, recemment
fog = brouillard
frog = grenouille
the run-up to the event = the period preceding a notable event ("a programme aimed at lowering unemployment in the run-up to the next election")
cap = casquette, capuchon (de crayon)
a bottle cap, a screw cap = un bouchon de bouteille
cork = bouchon de liège
stunning = extremely impressive or attractive, impressionnant
crown cork = capsule
to be in a good shape = être en (bonne) forme
a lid = un bouchon en plastique
un funnel = un entonnoir
to sicken someone = make (someone) feel disgusted or appalled, to become ill
thoughtful = réfléchi, pensif, soucieux, songeur
to (give a) whine = gémir, se plaindre, se lamenter
corpse = cadavre, corps
a whistle = un sifflet
a referee = un arbitre
jug = cruche, pot, carafe, broc
to lunge at someone, to make a lunge at someone = se jeter sur quelqu'un, se précipiter sur quelqu'un
relentless = implacable, impitoyable
to covet something = convoiter quelque chose
the forehead = le front (de la tête)
a haul = un butin, une distance à traverser
indebtedness = endettement
to sketch something = dessiner, esquisser, griffoner
ellipsis = elipse
group something under something = to classify something under some category
dotted line = ligne pointillée
to wind down = to gradually reduce work before stopping completely, to end or to finish something gradually, to relax after a period of excitement or worry
a handful = an amount that you can hold in your hand, a small amount or number
a bounty = une prime
the praise = la louange, l'éloge
a streak = une traînée, une période, un trait (de personnalité)
amps = ampères, amplis (musique)
the opposite of = le contraire de
a cue = une queue de billard, un signal
to heed something, to pay/give heed to = tenir compte de quelque chose, faire attention à quelque chose, to pay attention to, take notice of
a custodian = un gardien, un conservateur
goosebumps = chair de poule
to flee = fuire
basically, fundamentally = fondamentalement
on the contrary = au contraire, à l'inverse
a smuggler = un contrebandier, un trafiquant
to jettison = larguer/jeter (par dessus bord), abandonner, se délester de
a closeup = un gros plan
to slump against something = (s')effondrer sur quelque chose, tomber en arrière sur quelque chose
a retort = une replique
to dodge something = esquiver quelque chose
an assertion = une affirmation
madness = folie
to haul = pull or drag with effort or force, transporter
an epigraph = une inscription sur un bâtiment/statue/pièce, une citation au début d'un livre/chapitre
to borrow = emprunter
the stables = les écuries
to drag = tirer avec difficulté, tirer sur une cigarette
to get cleaned up = se laver
to wash up, to wash the dishes = laver la vaisselle
crockery and cutlery = vaisselle (assiettes, bols, tasses) et couverts (ou coutellerie)
shed = cabanon
the cherry on the cake (or on top) = la cerise sur le gâteau
constructively = helpful
it's slick = c'est lisse/luisant/brillant/astucieux/rusé
an oil slick = une marée noire
get all at once = récupérer tout d'un coup
to have evidence = avoir des preuves
partly, partially = en partie, partiellement
an inn = une auberge, un hôtel
overnight (adverb) = in or as if in the course of one night; suddenly (ex: became a sensation overnight)
it's not in my interest = ce n'est pas dans mon intérêt
to chicken out = to manage to get out of something, usually because of fear or cowardice
coward(ice) = lâche(té)
the crunch = le moment fatidique
to ramp up = to increase in volume, amount, or rate
a hostage = un otage
insane = fou, dément, insensé
a kettle = bouilloire
kettle corn = pop corn au caramel ou sucre
leg in plaster = jambe dans le plâtre
a spearhead = un fer de lance
a sword = une épée
to stab, a stab = poignarder, un coup de couteau
smithing equipment = équipement de métallurgie
it is drifting out to sea = il dérive en mer
an incentive = une motivation, une carotte, une incitation
to catch on (with someone) = devenir populaire (auprès de quelqu'un)
ever since = continuously since
apprentices = des apprentis
a dagger = une dague
a limb = un membre (du corps)
a relative = un membre de la famille
it's too much of a risk, it's too risky = c'est trop risqué
to overtake/to pass a car = dépasser une voiture
to do poorly = être médiocre
all along = tout du long, depuis le début
the jaw = la machoire
a rule of thumb = une règle générale
a thumb = un pouce
a digit = un doigt, un chiffre
a finger = un doigt
to dig = creuser
peculiar = particulier, étrange, spécial
it's jaw-dropping = it's amazing
trickery = tromperie, supercherie
to tease someone = taquiner quelqu'un
a broom = un balai
sidewalk = trottoir
to ponder = méditer, réfléchir, considérer, peser (le pour et le contre)
a complacency = une complaisance, une satisfaction
billard table/pool table = table de billard
pool / pool billards / pocket billards = billard
to settle down (in) = to ​become ​familiar with a ​place and to ​feel ​happy and ​confident in it / to ​start ​living in a ​place where you ​intend to ​stay for a ​long ​time, usually with ​your ​partner
mistletoe = du gui
words that are rarely if ever spoken = des mots qui sont rarement, si ce n'est jamais, utilisés à l'oral
luckily = heureusement, par chance
to be complimentary = gracieux, flatteur, faire des compliments
carpooling / car-sharing = covoiturage
to pool = form a pool on the ground or another surface / put (money or other assets) into a common fund / mettre en commun / unir
sparklinkg water/carbonated water = eau gazeuse
to be cut and dry = decided, set, settled, not open to change, simple, straightforward, clear, or certain
to huddle = se blottir, accumuler
to make up one's mind = se décider
a sparkle = un éclat, a glittering flash of light
it's doomed = c'est voué, c'est condamné
a scar = une cicatrice
the car stalled at the crossroad = la voiture a calé au croisement
to dwell on/upon something = s'attarder sur quelque chose
to dwell (in) = to live as a resident, to reside//to exist in a given place or state (ex: to dwell in joy)
a bake sale = une vente de pâtisseries
to squirm = se tortiller
sluggishly, slowly = lentement
a knot, a node = un noeud
a knob = poignée de porte en forme de boule
a dwarf, a midget = un nain
an accomplice = un complice
to fall apart = tomber en morceaux
unscathed = indemne, sain et sauf
to flinch = broncher
to wince = grimacer
the steering = le pilotage, la conduite
to steer = diriger, gouverner, conduire, tourner un volant
a shrine = un sanctuaire, un tombeau, un lieu saint, un lieu de pèlerinage
to toil (away) = peiner, travailler dur
a sanctuary = un sanctuaire
a golden hue = une teinte dorée
a sleeve = une manche (de vêtement)
to freak out = paniquer
a spike = une pointe
steel = acier
to gobble up = engouffrer (manger)
bumper cars (US English) / dodgems (British English) = auto tamponneuse
(travelling) funfair = fête foraine
dental braces = appareil dentaire
knock it off = quit or stop doing something
an impression = une immitation
individuals = particuliers
insofar as, to the extent that, in the sense that, in that = dans le sens où
it suits me = ça me convient
pretty, somewhat = quelque peu, un peu, plutôt
to be aloof = froid et distant
to track down something = to search out where someone or something is
to list something = répertorier, lister quelque chose
since then = depuis (à propos de choses qui se passent encore)
for then on = depuis (à propos de choses qui ne se passent plus maintenant)
to be mauled by an animal = se faire attaquer et déchirer la peau par un animal
a herdsman = un berger
to renounce = renoncer
psychosomatic = psychosomatique
to spring on something = sauter, se précipiter sur quelque chose
soaked = trempé, extremely wet
to feel rushed = se sentir dans l'urgence, pressé
historically = historiquement
squarely = carrément
thoroughly = complètemenet, parfaitement
deftly = adroitement
on my commute = sur mon trajet
to be wicked = être méchant, être malicieux
stepladder = escabeau
a (water) hose = un tuyau (d'arrosage)
ladder = échelle
faintly = à peine perceptible, faiblement, timidement
a dock = un quai (sur l'eau)
contemptuously = avec mépris, dédaigneusement
falsely = faussement, injustement
unsettlingly = troublant
to bootleg = vendre illégalement
it's rife = c'est répandu, commun
a mansion = un château, un hôtel particulier, une grande résidence
to rekindle something = raviver, rallumer, ranimer
suspenders (US), braces (UK) = bretelles
to dye hair = se teindre les cheveux
to be left out in the cold = être tenu à l'écart
unceasingly = sans cesse
haunted = hanté
frightful = very unpleasant, serious, or shocking
fright = effroi, peur, frousse
to be suspicious of = avoir des doutes sur
gypsy = (adj ou nom) gitan
in a good way = d'une bonne façon (ex: he is crazy, in a good way)
legit = légitime, conforming to the rules
a gated thing = quelque chose fermée
haughty = hautain, arrogant
to twist = tordre, déformer
to tweak = to twist, to pull something or to improve (a mechanism or system) by making fine adjustments to it
briefly = brièvement, rapidement
juice = jus
sharply = brusquement, vivement, nettement
to catch fire = prendre feu
to advocate = plaider, préconiser, recommander
to be verbatim = c'est du mot pour mot
a rejection = un refus, un rejet
cutting-edge = (adj ou nom) the position of greatest advancement or importance; the forefront
appendix (appendices) = annexe(s)
to be leaking = fuire (l'eau)
to lick = lécher
(bell) pepper = poivre (poivron)
try to keep up = essaie de suivre
glittery = paileté
to glitter = briller, scintiller
the glitter = les pailettes, lumière reflétée
put one's knowledge into practice = mettre son savoir en pratique
to put something into perspective = to ​compare something to other things so that it can be ​accurately and ​fairly ​judged
to get/keep something in perspective = to ​think about a ​situation or ​problem in a ​wise and ​reasonable way
a freak of nature = un monstre de la nature (en bien ou en mal)
they mingle with = ils se mélangent/mêlent/confondent avec
coconut = noix de coco
as to = quant à, according to, about, by, as for
as of now = à partir de maintenant
a trimmer = une tondeuse (cheveux/barbe)
to be intended to = être destiné à
a cartridge = une cartouche (d'encre ou contenant un film)
rough = rugueux, rude, grossier
tough = difficile, dur, sévère
a poltroon = a spiritless coward
gross = grossier, brut
aspect = aspect, a particular part or feature of something
a principle = un principe, un standard, a fundamental truth or proposition that serves as the foundation for a system
a propeller = une hélice (d'avion)
my man = se dit à propos d'un ami
yummy = delicious
to condone something = fermer les yeux sur quelque chose (faire semblant de ne pas voir/savoir)
a deal-breaker = a factor or issue which, if unresolved during negociations, would cause one party to withdraw from a deal
(to) overlap = (se chevaucher) chevauchement
to set off = partir (pour commencer un "voyage", rejoindre quelqu'un, etc)
a phone booth = une cabine téléphonique
a light breakfast = un petit déjeuner léger
to feel sorrow = ressentir de la douleur/du chagrin/de la peine/de la tristesse
a bolt from the blue, out of the blue = at a completely unexpected time, from an unexpected or unforeseen source
the MOT test = le contrôle technique
he has vanished = il a disparu
a bridegroom = un (futur) marié, un époux
honeymoon = lune de miel
the bride = la mariée
a pixelated image = une image pixelisée
blurry, to blur, a blur = flou, brouiller/estomper, une tâche/bavure
to disrupt = disrupter
to establish = établir (des règles), créer (un système), fonder (une entreprise), instaurer
to reflect, reflection = refléter (ex: a lot of the heat is reflected back into space) ou réfléchir/penser (ex: he reflected with sadness), réflexion ou reflet
to be delighted = être enchanté, ravi
serviceable = utilisable, commode, pratique
seamlessly = having no seams, perfectly consistent
seams = coutures, joint
flawlessly = having no defects or faults, especially none that diminish the value of something, perfect
to sew, sewing = coudre, couture
it's ongoing = continuing, still in progress
fluency = aisance, facilité
certain = certain, sûr, determiné, particulier
to head off (to somewhere) = partir quelque part
to spoil something (for someone) = to ruin something, gâcher quelque chose à quelqu'un
to be bald = être chauve
farther vs further = further est métaphorique ou le temps, farther est pour les distances physiques
shambolic = bordélique
a turn of phrase = une tournure de phrase
kickass = forceful, vigorous, and aggressive
a lobster = un homard
nutshell = coquille de noix
dramatically = de façon spéctaculaire, dramatiquement
the gist = l'essentiel
something lengthy = quelque chose long
hazelnut = noisette
counterpart = homologue
an everyday matter = une affaire de tous les jours
inductively = inductif
beware of something/someone = méfiez-vous de quelqu'un/quelque chose
to be watchful (upon something) = être vigilant (vis-à-vis de quelque chose)
to scourge someone = fouetter, châtier
literary = littéraire
to mumble = marmonner
a spot = un endroit
a point of interest = un endroit d'intérêt
embarrassment = embarras
an ounce = une once
finely = finement
to be on strike = être en grève
(the sun is) dazzling = (le soleil est) éblouissant
a daze = stupéfaction, ahurissement, hébètement
to put on makeup = se maquiller
to get dressed = s'habiller
chinese whispers = téléphone arabe
strolling down = marcher à faible allule
to dawdle = waste time, be slow
dawn = aube, aurore
a screw(driver) = (tourne)vis
the rough amount = la somme grosso modo
roughly = grossièrement, approximativement
to drill, a drill = percer, une perceuse ou des exercices
mindset = état d'esprit, mentalité
shoddy = de mauvaise qualité, poor
forthcoming = planned for or about to happen in the near future (ex: the forthcoming baseball season), à venir
an excerpt, to excerpt = un extrait, extraire (ex: the notes are excerpted from something)
an extension wire = une rallonge
it's a nice gesture on your part = un geste gentil de ta part
sheer frustration = pure frustration
to staple = agrafer
pea pods = cosses de petits pois
welfare = the health, happiness, and fortunes of a person or group
well-being, wellness = bien-être, bonheur
maiden = (adjectif ou nom) fille non marriée
it's typical of = c'est typique de (un pays par exemple)
righteous fury = fureur vertueuse, furie justifiée
to be doing well = aller bien (santé par exemple)
slaughter = abbatage, massacre, carnage, tuerie
to slaughter = tuer des animaux, tuer sauvagement
unfettered = sans entrave, libéré
thorough search = recherche approfondie/minutieuse
restraints = restrictions, modérations, contraintes
mulled wine = vin chaud
(un)comfortable, (un)comfy = (in)confortable
a vice = un vice, un défaut
cloakroom = vestiaire
clumsy = maladroit
to be striving (to strive) = s'efforcer de, lutter, se battre, faire son possible, s'acharner
sincerity = sincérité
to blow one's nose = se moucher le nez
to concede = concéder
unfailingly = indéfectiblement
infallibly = infailliblement
search warrant = mandat de perquisition
inevitably = inévitablement
to forestall = devancer, déjouer
confident = confiant
to admit = admettre
I'm basking = I'm exposed to warmth and light (sun, for example)
warm, the warmth = chaleureux/chaud/cordial, la chaleur
a disgrace = une disgrâce, une honte, un scandale
to purchase, to buy = acheter
callously = cyniquement
unfeelingly = inesthétique
it's (un)likely to rain = il va probalement (pas) pleuvoir
a serial killer = un tueur en série
a spree killer = un tueur en série (mais dans un laps de temps très court)
to harm someone = faire du mal à quelqu'un (physiquement ou mentalement)
a shootout = une fusillade
a gig = un concert
a keg of beer = un fût de bière
roast lamb = agneau rôti
to be dizzy = étourdi, pris de vertige
a feast = un festin, un banquet
hazy = brumeux, vague, voilé (la vue de quelqu'un saoul, par exemple, ou une photo)
it's too much of a stretch = something is being interpreted too liberally, going beyond what is reasonably the truth of the matter, and into the realm of speculation
broad = wide, large, big
sweetie = (UK) sweet (bonbon), sweetheart (US and UK)
convenient = pratique, commode
hump = bosse (ralentisseur sur la route)
bump = bosse (sur la peau par exemple)
to be fussy = être difficule (sur la nourriture par exemple), maniaque
something fuzzy = crépus, confus (cheveux en pétard), indistinct, vague (une image pas claire par exemple)
noun, midday = midi
a boiler = une chaudière, chauffe-eau
to unpack/pack stuff = défaire/préparer ses affaires
a pushchair = une poussette
wheelchair = chaine roulante
to hold my feelings back = retenir sentiments
to wear stubble = avoir une barbe de 3 jours
an eyelash = un cil
an eyebrow = un sourcil
frizzy hair = cheveux emmelés en pétard
to broaden = make something broad
a dent = un impact, un trou (sur la carrosserie d'une voiture par ex)
to be blue in the face = pale from exhaustion or exertion
an exertion = a vigorous action or effort
something happened from exhaustion = something happened because of the act or an instance of exhausting
a wheelie suitcase = une valise à roulettes
a rucksack (UK), a backpack (US) = un sac à dos
it's mild = c'est doux (température)
a shuttle = une navette
I have confidence in you = j'ai confiance en toi
a treat = un plaisir, un régal, une gaâterie (nourriture)
I come prepared = je viens préparé
tow = remorquer
stained glass = vitrail
itch = démanger (it's itching = ça me démange)
doll = poupée
a pear = une poire
I'm screwed = je suis foutu
ruthless = impitoyable
a sip = une gorgée
to be worthy = avoir de la valeur
drawback, downside = inconvénient, désavantage
mentality = mentalité
(to) bargain = (négocier, marchander, ) une bonne affaire, une occasion
consumer society = société de consommation
spark = étincelle
coarse people = des gens grossiers
strained friendship = amitié tendue/forcée
economic gloom = morosité économique
eerily = étrangement
to be phony = somebody who pretends to be something else
weirdly = bizaremment
livelihood = gagne-pain
harsh = dur, rigoureux, sévère
to break down misconceptions = casser les fausses idées/idées reçues
to cower = se récroqueviller
to mess around = to waste time; to do something ineffectually
a pitfall = un piège
to foreshadow = présager
in the long term, in the long run = sur le long terme
a brooding patriarch = un patriarche broyant du noir
a bird is brooding eggs = un oisant couve des oeufs
akward = génant, embarrassant, maladroit
ticklish = chatouilleux
the disillusionment = la désillusion
a sandpit, a sandbox = un bac à sable
to arouse/to picke one's curiosity = éveiller la curiosité
eccentric = excentrique
it's a moot point = c'est discutable
to scratch = gratter
it's tickly, it tickles me = ça me chatouille
chatty = bavard, familier
grateful to you = reconnaissant envers toi
a rug = un tapis
which spiralled out of control = qui a échappé à tout contrôle
banish = bannir
a bid = une offre, une enchère
to be stingy = not liking or wanting to give or spend money (not generous), small in size or amount
to brag about someone or something, to boast = se vanter
boastful = ventard
ostentatious = ostentatoire, prétentieux
sassy = insolent
uncompromisingly = sans compromis
it's forthright = c'est franc, direct
a dubbed movie = un film doublé (vocalement)
undies = sous-vêtements
coitus = coït
to be blathering about something = déblaterer sur quelque chose
get chopped = se faire hâcher, broyer
to take up = to start doing something regularly as a habit, job, or interest / to fill a particular amount of space or time
lodged = déposé
cuss words, swear word = jurons, gros mot
a bruised knee = un genou avec un bleu
to be supportive = providing encouragement or emotional help
it's effective, it's efficient = c'est efficace (Being effective is about doing the right things, while being efficient is about doing things right)
to scatter something = disperser quelque chose
the bosom of the ocean = au sein de l'océan
he abides = il respecte, il demeure, il supporte
allowing Whitey to evade law enforcement = qui a permis à Whitey d'échapper à la loi
presumed = présumé
ubiquity = ubiquité, omniprésence
you're most welcome = you're very welcome
in this day and age = at the present time
delightful = déliceux, ravissant, charmant
albeit = quoique, bien que
dystopian = dystopique (également appelée contre-utopie, est un récit de fiction dépeignant une société imaginaire organisée de telle façon qu'elle empêche ses membres d'atteindre le bonheur)
works like a charm = fonctionne bien
pleasant = plaisant
to contravene = contrevenir, enfreindre
satisfying = satisfaisant
glad to be of service = ravi de t'être utile
infer = déduire, insinuer
wishy-washy = thin and watery, as tea or soup; insipid, lacking in strength of character or purpose; ineffective; weak in willpower
suggest = suggérer, insinuer
to show off = frimer, crâner
make an educated guess = déviner en réfléchissant
catchphrase, catchline = phrase connue, célèbre, prise d'un film par ex
slip them into the conversation = insérer quelque chose dans la conversation
to rely on = compter sur, appuyer sur (pas au sens physique)
ecosystem = éco-système
hugely = énormément
a cruise = une croisière
at the moment = en ce moment
willpower, willingness = volonté
steep = raide, abrupt
learning curve = courbe d'apprentissage
autonym = contraire
a slope = une pente
she turns me on = elle me chauffe
all good things must (come to an) end = toutes les bonnes choses ont une fin
good riddance = bon débarras
a rise, an ascent = une montée
cautious = prudent
specifically = spécifiquemen
ta descent = une descente
gentle = doux (quelqu'un ou quelque chose, par ex : une pente douce), gentil
gradual = graduel
little by little, gradually = petit à petit
(un)common = (non) commun
along (or down) the line = at a further, later, or unspecified point
jar = bocal, pot
to throttle someone = étrangler quelqu'un
prone to glitch(es), glitchy = sujet à anomalie(s)
aware of = conscient de
peanut (butter) = (beurre de) cacahuète
stagnate = stagner
a cellar = une cave
to doze, to snooze, to take a light nap = courte sieste
under (3D)/below (2D)/beneath (formal 'under')/underneath (emotional 'under') the table = sous la table (http://www.phrasemix.com/answers/whats-the-difference-between-under-below-beneath-and-underne)
aboard the ship = à bord du navire
backward, forward = en avant, en arrière
it's mesmerising = hypnotisant
to rip someone off = to steal [something] from someone, to cheat someone
to give a 1-month notice = donner un préavis d'un mois
ecstatic person = person en extase
to outscore = se démarquer
a whale of a time = a very enjoyable experience
powder = poudre
a butler = un majordome, un maître d'hôtel
until middle age = jusqu'à 45-65 ans
gigantic = gigantesque
unclog = désobstruer (remove accumulated matter from)
shower drain = évacuation d'eau dans la douche
bathtub = baignoire
to wrap gifts with wrapping paper = emballer des cadeaux avec du papier cadeau
rubber = caoutchouc
gloves = gants
adorable = adorable
to hand over something to someone = donner quelque chose à quelqu'un
unfold = dérouler, déplier
(it's) reminiscent of = cela rappelle ceci
beforehand = au préalable
a shovel = une pelle
in advance = en avance, par avance
throughout = partout dans, tout au long de
give things away = donner
paper clip = trombone
(a reel of/a roll of) adhesive tape = (une bobine de/un rouleau de) scotch
it's unprecedented = c'est sans précédent
harmony = harmonie
to yell at someone = crier, hurler
to be mean = être méchant
they crushed it = ils ont géré
be a jerk = un salop
to be complete = être fini/achevé
to end (by) doing = finir par faire
garlic = ail
client vs customer/consumer = client professionnel vs client particulier
anchovy = anchois
lateness = fait d'être en retard
slang = argot
dialect = dialecte
salad = salade de fruits/légumes (!= de la salade verte)
temperament = tempérament
they went down well with the fans = ils ont été bien accueillis par les fans
region = région
frequently = fréquemment
content = content, satisfait
complementary = complémentaire
to convey = transporter, communiquer
a convoy = un convoi
to be accurate = être précis, juste
talk TO someone = parler à quelqu'un
it's stimulating = c'est stimulant
grumpy = grincheux, ronchon, bad-tempered and sulky
sulky = boudeur, maussade
flour = farine
pastry = pâtisserie ou pâte (pour la pâtisserie, les pizzas)
nevermind = oublie, t'inquiete
granulated sugar = sucre en poudre
to wax = s'épiler à la cire
a drag = une taff de cigarette
pain = douleur
toothpaste = dentifrice
someone smelly = qui pue
I'm broke = je suis ruiné
badly = mal, gravement
to have proficiency in = avoir des compétences, de ma maîtrise
a wire transfer or credit transfer = un virement bancaire
with reluctance, with unwillingness = avec réticence
a fleet = une flotte (de bateaux par ex)
to be close with one's money = être proche de ses sous
to work closely with someone = in a way that involves sharing ideas, thoughts, or feelings
armrest = accoudoir
solely, only = seulement
sore = douloureux, irrité, inflammé
premptive = préventif, de préemption
inconvenient = incommode, génant, innoportun
premises = locaux
coal = charbon
get somebody's hopes up = to make someone think that what they want is going to happen ("If we can't afford the trip then we shouldn't get the children's hopes up")
to be provident = être prévoyant
it's thriving = c'est en plein essor
to thrive = se développer, prospère, grandir (animal ou humain)
dread = crainte, terreur
summit = sommet
we indulge in cakes = on s'autorise (pour se faire plaisir) des gâteaux
something is aging = quelque chose est vieillissant
mesh = filet, réseau
electrical grid = réseau électrique
on the morrow, they... = le lendemain (matin), ils...
herring = hareng
and so forth, and so on = et ainsi de suite
monolithic = monolithique, formed of a single large block of stone
a tin = une boite de conserve
a can = une canette
to socialise with someone = socialiser avec quelqu'un
to reach the stage = atteindre le moment, le pallier, le point
to feel obligated = se sentir obligé
my in-laws = mes beaux-parents
to go grocery shopping = faire les courses
to postpone something until/to, defer = décaler à (une date)
it's likely/unlikely I would ... = il est probable/improbable que je ...
the likelihood = la probabilité
to rubb something = frotter
they look quite similar, they look quite alike = ils se ressemblent
to puck, to vomit, to throw up = vomir
a sink = un évier
a seagull = une mouette
a sea lion = une otarie
a seal = un phoque
a walrus = un morse
courteous = courtois
a sink plug (~ sink stopper) = bouchon
rusty = rouillé
they get along well (with someone else) = ils s'entendent bien (avec quelqu'un)
bring it in = rentrer la (la poubelle)
let's call it a day = faisons-en une journée (se dit quand on part du travail)
knock wood = touchons du bois
smoothie = jus de fruits
here you go = et voilà (pour vous)
berry = baie
genuinely = vraiment, authentiquement
faithful, loyal, truthful, true, devoted = fidèle
cranberry = canneberge
strawberry = fraise
red tape = official routine or procedure marked by excessive complexity which results in delay or inaction, a series of actions or complicated tasks that seem unnecessary but that a government or organization requires you to do in order to get or do something
miss out on something = to fail to participate in something; to fail to take part in something; rater quelque chose (râter un gâteau, louper/manquer un évènement)
tiptoe = sur la poite des pieds
willow tree = saule plaureure
tulip = tulipe
to be knee-deep in the snow = être enfoncé dans la neige jusqu'aux genoux
depth = profondeur
moonlight = clair de lune
pillow = oreiller
a cushion = un coussin
to be affected by something = être affecté par quelque chose
oak = chêne
orm = orme
to strengthen = renforcer
get back = rentrer, revenir
you copy? = tu reçois ? (se dit au travers d'un talkie walkie)
to be flooding = innonder, remplir
gleaming = luisant
gleamworm = ver luisant
long-term commitment = engagement à long terme
sincerely = sincèrement
obituaries = nécrologies
to distinguish = distinguer
to lust after someone = avoir envie de quelqu'un sexuellement
it's poisonous = c'est du poisson
rewarding, worthwhile = qui en vaut la peine
fulfill = réaliser (un rêve), accomplir
an approach = une approche
to comply with/be compliant with = être conforme avec
to demand something = demander quelque chose
vinegar = vinaigre
couch, sofa = canapé
blinds = volets, stores
enlightenment = éclaircissement, lumières
turn up/down the volume = monter/baisse le volume/son
to be blind = être aveugle
meanwhile, (in the) meantime = pendant ce temps, en même temps
to be deaf = être sourd
to pretend = faire semblant
to trust someone = croire quelqu'un, faire confiance à quelqu'un
to fill = remplir
concussion = commotion cérébrale
to be injured = être blessé
to be freed = être libéré
to break into something = s'introduire par effraction
bumper = pare-chocs
(un)fair = (in)juste
a wound = une blessure
wealth = richesse
burdensome responsibilites = responsabilités pénibles
a bounce = un rebond
to toss = throw (something) somewhere lightly, easily, or casually
to pitch something = throw or fling roughly or casually
to fling something = throw or hurl forcefully
to wail = give a cry of pain, grief, or anger
one after another = l'un après l'autre
occult = occulte
in turn = in the appropriate point in the series or order; when one's turn comes / one after the other / as an equal or related effect
a rocking chair = une chaise/un fauteuil à bascule
to intervene in something = intervenir dans quelque chose
to interfere with something = interférer/intervenir dans quelque chose (perturber)
if I were in your shoes = si j'étais toi
no offense to you = sans vouloir vous offenser
an offense = une offense envers quelqu'un, un acte illégal
fever = fièvre
reluctant = réticent, peu disposé
it ought to be = it should be
it gives insights into him = the capacity to gain an accurate and deep intuitive understanding of a person (or thing), a better understanding of
a dip = une courte baignade (= un plongeon)
to crack jokes = faire des blagues
they're bound to cluster up by then = ils sont tenus de se regrouper d'ici là
the armory = l'armurerie
by the by, by the way = au fait, au passage, à propos
large quantities of ammunition = beaucoup de munitions
flares = fusées (de détresse par exemple)
gate = porte, grille
just stumbled upon/on/across this, just came across this = juste tombé sur
let me in = laisse moi entrer
syrup = sirop
watch out = fais gaffe, attention
a shelf = une étagère
innocuous, harmless = innofensif, pas dangereux
to knock something over = renverser quelque chose
a nightstand = une table de nuit
to brace something with something = consolider quelque chose avec quelque chose
a grip (of a gun), a hold = une poignée
to grasp something, to grip something = saisir fermement
tightly, firmly = fermement
it's drawing more of them = ça en attire plus (des gens par exemple)
to look out for someone = attendre quelqu'un, surveiller quelqu'un
apparently, seemingly = apparemment
gorgeous = magnifique, slendide (se dit à propos de quelqu'un)
to waste something = gâcher quelque chose
lock-picking = crochetage
my skill set = mes compétences
capabilites = capacités, aptitudes
I'm resting my eyes = je repose mes yeux
to block something = bloquer quelque chose
to be tied up = être ligoté
to squeeze in/through = passer à travers un petit espace
bed sheets = draps
to gut something = vider quelque chose
his gut = son intestin
to be brave = être courageux
step aside = écarte toi
turn back, turn around = faire demi-tour
dead-end street = impasse
a turnaround = un retournement de situation favorable
lower it = baisse ça
slide them over = faites les glisser
thanks for having me = merci de m'avoir reçu
bony = osseux, maigre
to ensure something = s'assurer de quelque chose
dominance = domination
to foreshadow = présager, annonce
to top up a card = recharger une carte
look it up on Google = cherche ça sur Google
to hook up with someone = embrasser ou coucher avec quelqu'un
to make out with someone, to make out in something/something made out better than expected = embrasser ou coucher, bien gérer une situation/quelque chose s'est bien passé
slightly = légèrement
waffles, to waffle = gauffres//parler pour ne rien dire
to sneak in = entrer furtivement
to pack a suitcase = préparer sa valise
that smug expression = cette fière allure
condescending = condescendant
to give someone a lift (UK)/ride (US)/drive home = amener quelqu'un chez lui
by chance = par accident, par hasard
garage, automobile repair shop = garage de réparatation de voiture
workforce = les effectifs, les employés
naughty = vilain, méchant, coquin
aside from you = à part toi
beanie = bonnet
reverse the question = retourner la question (à quelqu'un)
bouldering, climbing = escalade
climate = le climat
ice skating = patinage
either way = dans tous les cas
controversial = controversé
it smacks of racism = cela ressemble à du racisme
we can show up = nous pouvons nous présenter (dans le sens "se montrer")
to finish something off = finir quelque chose complétement
to take on the shape of a unicorn = prendre l'appararence d'une licorne
potato peeler = épluche légumes
mixed herbs, Provencal herbs = herbes de Provence
he is such a cunt = c'est un tel enculé
to work in concert = travailler ensemble
with one another = avec chacun
to entail = entraîner (des conséquences par exemple)
colloquial = familier
it's none of your business = ça ne te regarde pas
toiletries = affaires de toilette
earlier on today = plus tôt aujourd'hui
coat = manteau, pelage d'animal
to groom = toiletter (un animal)
a night owl = un couche-tard
schoolyard = cour de récréation
stardom = célébrité, gloire
an early bird = un lève-tôt
to foster something = encourage or promote the development of (something, typically something regarded as good).
silly = bête, idiot
stint = a person's fixed or allotted period of work
that's icing on the cake = c'est la cérise sur le gâteau
a point of contention = un point de conflit, de concurrence
a wrist = un poignet
continuously = continuellement
ironic = ironique
neatly = soignement
(to) busy = (occuper) occupé
irony = ironie
to keep on with something = to continue with something
keep/lose one's temper = garder/perdre son calme/sang-froid
sarcasm = sarcasme
to blow = souffler
to enlighten = éclairer
to hone one's skills, to be honing a blade = perfectionner ses capacités, affûter une lame
to sharpen = aiguiser, affûter
to take the bull by the horns = prendre le taureau par les cornes
sharp = pointu, aigu, vif
illuminate = illuminer
acute and grave sound = son aigü et grave
staircase = cage d'escalier
parcels = parcelle, colis, paquet
an endorsement = une approbation, un appui
dressing gown = robe de chambre
liven up something, make lively something = rendre vivant quelque chose
merely, mere = simplement, simple
guesswork = conjectures, hypothèses
to come up = en arriver à, to come near, to turn out to be
barely, scarcely = à peine
altogether = complétement, entièrement
to accelerate, to speed up = accélérer
tremendous = énorme, immense
a bow = un arc
a crossbow, an arbalest = une arbalète
a bow tie = un noeud papillon
a bench = un banc
from time to time, occasionally = de temps en temps
(ir)regularly = (ir)régulièrement
what use do you make of it? = quel usage en fais-tu ?
the shore = la rive, le rivage, la côte
soon after, shortly after = peu après
resilience = résistance, élasticité
sustainable energy = énergie durable
renewable energy = énergie renouvelable
last but not least = enfin, et non des moindres
a household = un ménage (une famille)
to be absorbed = être absorbé
accordingly = en conséquence
jointly = en coopération
an outcome = une finalité, une fin, the way a thing turns out, une conséquence
a stove = un poêle, un fourneau, un four
to stove something = (ré)chauffer de la nourriture
board games = jeux de société
currency exchange = échange de monnaie (de devise)
toddler = bébé qui commence à marcher, bambin
getting nervous = s'inquiéter
nagging = harcelant
copper needles = aiguilles de cuivre
a shelf life = une durée de vie
a fortnight = a period of two weeks
the momentum = l'élan
